#########S........######################
#################.######################
#################.######################
#################........###############
########################.###############
########################.###############
#########................####.......####
#########.###################.#####.####
#########.##############......#####.####
#########.##############.##########.####
#########................##########.####
###################################.####
###########.............###########.####
###########.###########.............####
###########.############################
###########.############################
###########.############################
###########.############################
###########...........##################
#####################.#######......#####
#####################.#######.####.#####
#####################.#######.####.#####
#########.............###.....####.#####
#########.###############.########.#####
#########.###############.########.#####
#########.###############.########.#####
#########.................########.#####
##################################.#####
####################...............#####
####################E###################