##################################.#####
##################################.#####
#############################......#####
#############################.##########
###############..........####.##########
###############.########.####.......####
###############.########.##########.####
###############.########.##########.####
####.......####.########............####
####.#####.####.########################
####.#####.####.########################
####.#####.####..........S##############
####.#####.##############.##############
####.#####....###########.##############
####.########.###########.##############
####.########.###########.##############
####.....####.###########.##############
########.####.............##############
########.###############################
########.###############################
########.###############################
########.............###################
####################.###################
####################.##..........#######
##############.......##.########.#######
##############.########.########.#######
##############.########.########.#######
##############.########.########.#######
##############..........########.#######
################################E#######